###                                                                                                  ################
###           #   #### #        #      ##   #  ##                                                    ################
###           #   #    #       # #     # #  #  # #                                                   ################
###           #   #    #     #     #   #   ##  # #                                                   ################
###           ### #### #### #       #  #    #  ##                       ##                           ################
###                                                                      #                           ################
###                             #                                        #                           ################
###       ###                  ##                     #####              #                           ################
###                           ####                                                                   ################
###               #####     #######                                                                  ################
#####################################################################################################################
#####################################################################################################################
#####################################################################################################################
#####################################################################################################################
#####################################################################################################################
