################################################################################################################################################################
##                                                                                                                                                             #
##                                                                                                                                                             #
##                                                                                                                                                             #
##                                                                                                                                                             #
##                           GGGG                                                                                                                              #
##                   P 1#     G      GGGGGGGGGGGGGGGGGGG                                                                                                       #
##                  #####                                                                                                            2                         #
##                                                     m                                                           ##                                          # 
##             GGG                                              m                                                 #  #                                         #
##         m                    #                                                                                #    #                                        #
##        ###                  ###                    #####                                                     #      #                                       #
##                         m  #####                                     m                1   1  1              #        #                                      #
##    m           #####      #######            m                                       m m m m  m            #          #                             $       #
GGGGGGGGGGGGGGGGGGGGGGGGGGGGGGGGGGGGGGGGGGGGGGGGGGGGGGGGGGGGGGGGGGGGGGGGGGGGGGGGGGGGGGGGGGGGGGGGGGGGGGGGGGGGGGGGGGGGGGGGGGGGGGGGGGGGGGGGGGGGGGGGGGGGGGGGGGGGGGGG
##                                                                                                                   
##  
##                                                                                                                   
##                                                                                                                   
##                                                                                                                   
