##                                                                                                   #               
##  P         #   #### #        #      ##   #  ##                                                    #               
##            #   #    #       # #     # #  #  # #                                                   #               
##            #   #    #     #     #   #   ##  # #  mmmmmmmmm                                        #               
##            ### #### #### #       #  #    #  ##                                                    #               
##                                                                                                   #               
##                                                                                                   #               
##          GGGGGGGGGGGGG   mmm                                                                      #              
##         GGGGGGGGGGGGGGG       G                                                                   #               
##        GGGGGGGGGGGGGGGGG     GGG                                         G       mmmmmmmm 2       #               
##       GGGGGGGGGGGGGGGGGGGGGGGGGGGGGG                                   GGG                        #              
##      GGGGGGGGGGGGGGGGGGGGGGGGGGGGGGGGGGGGGGGGGGG                    GGGGGG                        #               
##     GGGGGGGGGGGGGGGGGGGGGGGGGGGGGGGGGGGGGGGGGGGGGGGGGGGGGGGGG    GGGGGGGGG                       $#               
##GGGGGGGGGGGGGGGGGGGGGGGGGGGGGGGGGGGGGGGGGGGGGGGGGGGGGGGGGGGGGGGGGGGGGGGGGGGGGGGGGGGGGGGGGGGGGGGGGGG#                  
##GGGGGGGGGGGGGGGGGGGGGGGGGGGGGGGGGGGGGGGGGGGGGGGGGGGGGGGGGGGGGGGGGGGGGGGGGGGGGGGGGGGGGGGGGGGGGGGGGGGG
