##                                                                                                   #               
##  P         #   #### #        #      ##   #  ##                                                    #               
##            #   #    #       # #     # #  #  # #                                                   #               
##            #   #    #     #     #   #   ##  # #                                                   #               
##            ### #### #### #       #  #    #  ##                       ##                           #               
##                                                              i        #                           #               
##                              #                                        #                           #               
##        ###                  ##                     #####              #                           #               
##                            ####                                                                   #               
##                #####     #######                                                                  #               
##                                                                                                   #               
##                                                                                                   #               
##                                                                                                   #               
##                                                                                                   #
######################################################################################################                  

