######################################################################################################
##                                                                                                   #
##                                                                                                   #
##                                                                                                   #
##                                                                                                   #               
##                           GGGG                                                                    #               
##                   P      G      GGGGGGGGGGGGGGGGGGG                                               #            
##                  #####                                                                            #               
##                                                     m                                             #               
##             GGG                                              m                                    #               
##         m                    #                                                                                    
##        ###                  ###                    #####                                                      
##                         m  #####                                     m                                            
##    m           #####     ########            m                                       m m m m  m                   
GGGGGGGGGGGGGGGGGGGGGGGGGGGGGGGGGGGGGGGGGGGGGGGGGGGGGGGGGGGGGGGGGGGGGGGGGGGGGGGGGGGGGGGGGGGGGGGGGGGGGG
##                                                                                                                   
##                                                                                                                   
##  
##                                                                                                                   
##                                                                                                                   
