#              
#           #   #### #        #      ##   #  ##                                                    #
#           #   #    #       # #     # #  #  # #                                                   # 
#    ###    #   #### #      #####    #  # #  #  #                                                  #
#           #   #    #     #     #   #   ##  # #                                                   #
#           ### #### #### #       #  #    #  ##                       ##                           #
#                                                                      #                           #
#                             #                                        #                           #
#       ###                  ##                     #####              #                           #
#                           ####                                       #                           #
#               #####     #######                                                                  #
####################################################################################################
