##                                                                                                   #               
##            #   #### #        #      ##   #  ##                                                    #               
##            #   #    #       # #     # #  #  # #                                                   #  Q    Q    Q  
##            #   #    #     #     #   #   ##  # #                                                   #               
##            ### #### #### #       #  #    #  ##                       ##                           #               
##                                                              i        #                           #               
##                              #                                        #                           #               
##        ###                  ##                     #####              #                           #  Q    Q    Q  
##                            ####                                                                   #               
##                #####     #######                                                                  #               
##                                                                                                                   
##                                                                                                                   
##  Q    Q    Q    Q    Q    Q    Q    Q    Q    Q    Q    Q    Q    Q    Q    Q    Q    Q    Q    Q    Q    Q    Q  
##                                                                                                                   
##                                                                                                                   
