################################################################################################################################################################
##                                                                                                                                                             #
##                                                                                                                                                             #
##                                                                                                                                                             #
##                                                                                                                                                             #
##                           GGGG                                                                                                                              #
##                     1#     G      GGGGGGGGGGGGGGGGGGG                                                                                                       #
##                  #####                                                                                                                                      #
##                                                     m                                                           ##                2                         # 
##             GGG                                              m                                                 #  #                                         #
##        m                     #                                                                                #    #                                        #
##       ###                   ###                    #####                                                     #      #                                       #
## P                       m  #####                                     m                    1                 #        #                                      #
##    m       $   #####      #######            m                                       m m m m  m            #          #                             $       #
GGGGGGGGGGGGGGGGGGGGGGGGGGGGGGGGGGGGGGGGGGGGGGGGGGGGGGGGGGGGGGGGGGGGGGGGGGGGGGGGGGGGGGGGGGGGGGGGGGGGGGGGGGGGGGGGGGGGGGGGGGGGGGGGGGGGGGGGGGGGGGGGGGGGGGGGGGGGGGGG
##                                                                                                                   
##  
##                                                                                                                   
##                                                                                                                   
##                                                                                                                   
