##                                                                                                                                                                                                                                                                                                                                                                                                                               #
##                                                                                                                                                                                                                                                                                                                                                                                                                               #
##                                                                                                                                                                                                                                                                                                                                                                                                                               #
##                                                                                                                                                                                                                                                                                                                                                                                                                               #
##                                                                                                                                                                                                     mmmmmmmmmmmmmmmmmmmmmmmmmmmmmmmmmmmmm                                                                                                                                                                                     #
##                                                                                                                                                                                                                                                                                                                                                                                                                               #
##                                                                                                                                                                                                                                                                                                                                                                                                                               #
##                                                         GGGG                                                                                                                                                                                                                                                                                                                                                                  #
##                                                                                                                                                                                                                                                                                                                                                                                 mmmmmmmmmmmmmmm                               #
##                                                                                                                               G                                                                                                   GGGGG                                                                                                                                                                                       #
##                                                     G                                                                        GGG    mmmmmm                                                                                                     GGGGGGGGGGGGGGGGG                                                                                                                                                              #
##                                                    GGG                                                                      GGGGG                                                                                                              GGGGGGGGGGGGGGGGGGGGGGGGGG                                                                                                                             2                       #
##            1                                      GGGGG    mmmmmm                                                  GGGGGGGGGGGGGGGGGGGGGGGGGGG                                                    GGGGGGGGGGGGGGGGGGGGGGGGGGGGGGG              GGGGGGGGGGGGGGGGGGGGGGGGGGGG                                                                                                                                                   #
##                                                  GGGGGGG             GGGGGGGGGGGGGGGGGGGGGGGGGGGGGGGGGGGGGGGGGGGGGGGGGGGGGGGGGGGGGGGGGGGGGGGGGGGGG                     GGGGGGGGGGGGGGGGGGGGGGGGGGGGGGGGGGGGGGGGGGGGGGGGGGGGGGGGGG              GGGGGGGGGGGGGGGGGGGGGGGGGGGGGGGGGGGGGGGGGGGGGGGGGGGGGG                                                                                                              $          #
GGGGGGGGGGGGGGGGGGGGGGGGGGGGGGGGGGGGGGGGGGGGGGGGGGGGGGGGGGGGGGGGGGGGGGGGGGGGGGGGGGGGGGGGGGGGGGGGGGGGGGGGGGGGGGGGGGGGGGGGGGGGGGGGGGGGGGGGGGGGGGGGGGGGGGGGGGGGGGGGGGGGGGGGGGGGGGGGGGGGGGGGGGGGGGGGGGGGGGGGGGGGGGGGGGGGGGGGGGGGGGGGGGGGGGGGGGGGGGGGGGGGGGGGGGGGGGGGGGGGGGGGGGGGGGGGGGGGGGGGGGGGGGGGGGGGGGGGGGGGGGGGGGGGGGGGGGGGGGGGGGGGGGGGGGGGGGGGGGGGGGGGGGGGGGGGGGGGGGGGGGGGGGGGGGGGGGGGGGGGGGGGGGGGGGGGGGGGGGGGGGGGGGGGGGGGGGGGGG
