#############################################
#                                           #   
#                                           #
#                                           #
#                                           # 
#                                           #
#                                           #
#                                           #
#                                           #
#                                           #
#                                           #
#                                           #
#                                           #
#                                           #
#                                           #
#                                           #
#                                           #
#############################################
